1S11000000000000000011000000000011111111
1011011111101111111011011011111011000001
1011011111101111111011011011111011011101
1000000000000000000000000000000011011101
11110110111011011111111100Y0111000011101
1111011011101100000000110110111011111001
1000011010001111111110000000111011111011
1011011011000111111111111110111011100011
1011011011101111111111111110111011101111
1000011000000000000000000000000000000001
1111011011101111011111110110111000111001
1000011011101111000000000000110000111011
1011011011101111111111111111110001111001
1011011011101100000000000000011011111101
1000011011000000000000000000010000000001
1111111011110111100111110110011000111111
000001101111011100B011100000010000100001
0000000011110111000011101101010001101101
0000011111110111111111101101011011101101
0000011011110000000000000000010000000001
0111011011111111101111111111111111111111
0000011011111111101111111111110000110001
0000011000000000000000000000010001100101
0000011011111111111111111111111011001101
00000110110000000000000000P0000000000001
1111111011100110111110110110011010110101
0000000011100110000000000000011010110101
0111111011100110111110111111011010000101
0000000000000110000000000000011000110001
11111111111111111111111111111111111111E1